"filename", "language", "CSS", "JavaScript", "comment", "blank", "total"
"c:\Users\anxoa\WebstormProjects\library-app-alpha\src\components\AdminDashboard.css", "CSS", 44, 0, 0, 6, 50
"c:\Users\anxoa\WebstormProjects\library-app-alpha\src\components\AdminDashboard.js", "JavaScript", 0, 17, 0, 0, 17
"c:\Users\anxoa\WebstormProjects\library-app-alpha\src\components\Authors.js", "JavaScript", 0, 14, 0, 1, 15
"c:\Users\anxoa\WebstormProjects\library-app-alpha\src\components\BookDetails.js", "JavaScript", 0, 29, 0, 0, 29
"c:\Users\anxoa\WebstormProjects\library-app-alpha\src\components\Books.js", "JavaScript", 0, 30, 0, 1, 31
"c:\Users\anxoa\WebstormProjects\library-app-alpha\src\components\EditBook.js", "JavaScript", 0, 20, 0, 2, 22
"c:\Users\anxoa\WebstormProjects\library-app-alpha\src\components\Navbar.css", "CSS", 2, 0, 0, 0, 2
"c:\Users\anxoa\WebstormProjects\library-app-alpha\src\components\Publisher.js", "JavaScript", 0, 2, 0, 0, 2
"c:\Users\anxoa\WebstormProjects\library-app-alpha\src\components\Reservations.css", "CSS", 16, 0, 0, 2, 18
"c:\Users\anxoa\WebstormProjects\library-app-alpha\src\components\Reservations.js", "JavaScript", 0, 9, 0, 0, 9
"Total", "-", 62, 121, 0, 12, 195